,Record,Total complement sites,Total reverse complement sites,Total number of sites,Perc DNA modified (total),motif seq,record length
0,chr1,2711704,2705867,5417571,1.0880560855746872,TNTC,248956422
1,chr2,2950551,2938885,5889436,1.215853293916866,TNTC,242193529
2,chr3,2383531,2386194,4769725,1.2026807418314396,TNTC,198295559
3,chr4,2277203,2274467,4551670,1.1964568116251673,TNTC,190214555
4,chr5,2165749,2166298,4332047,1.1931498693066125,TNTC,181538259
5,chr6,2062022,2061642,4123664,1.2071193362616421,TNTC,170805979
6,chr7,1845129,1844916,3690045,1.1578720599358983,TNTC,159345973
7,chr8,1758777,1759180,3517957,1.2119298819922768,TNTC,145138636
8,chr9,1428803,1427879,2856682,1.0320776912315228,TNTC,138394717
9,chr10,1585839,1586283,3172122,1.1854197011359457,TNTC,133797422
10,chr11,1583956,1579960,3163916,1.1710693306106952,TNTC,135086622
11,chr12,1544824,1545228,3090052,1.159273995755658,TNTC,133275309
12,chr13,1202461,1196247,2398708,1.0487133715331234,TNTC,114364328
13,chr14,1058226,1053719,2111945,0.986487128558072,TNTC,107043718
14,chr15,987409,986597,1974006,0.9677335951049655,TNTC,101991189
15,chr16,907894,902121,1810015,1.0017977415902406,TNTC,90338345
16,chr17,877115,874105,1751220,1.0516897822982574,TNTC,83257441
17,chr18,949580,947626,1897206,1.180246645387208,TNTC,80373285
18,chr19,527332,527818,1055150,0.9000280734719747,TNTC,58617616
19,chr20,736328,727143,1463471,1.1354565262671483,TNTC,64444167
20,chr21,457762,455080,912842,0.9771380135162969,TNTC,46709983
21,chr22,399104,399801,798905,0.7860380600218017,TNTC,50818468
22,chrX,1668163,1668110,3336273,1.0690380236539916,TNTC,156040895
23,chrY,282662,281883,564545,0.4932469866059825,TNTC,57227415
0,chr1,5464014,5454457,10918471,2.1928478310151807,TNTM,248956422
1,chr2,6090662,6072966,12163628,2.511138107244806,TNTM,242193529
2,chr3,4995529,4995588,9991117,2.5192488047601715,TNTM,198295559
3,chr4,4931636,4928661,9860297,2.591888144416709,TNTM,190214555
4,chr5,4543924,4544141,9088065,2.503071542621768,TNTM,181538259
5,chr6,4321908,4318203,8640111,2.529217961392323,TNTM,170805979
6,chr7,3802059,3801065,7603124,2.3857283170877497,TNTM,159345973
7,chr8,3625124,3626082,7251206,2.498027472161169,TNTM,145138636
8,chr9,2899278,2898458,5797736,2.094637759908133,TNTM,138394717
9,chr10,3176316,3174668,6350984,2.3733581354056286,TNTM,133797422
10,chr11,3182005,3177492,6359497,2.35385891876103,TNTM,135086622
11,chr12,3176462,3174958,6351420,2.38281946133023,TNTM,133275309
12,chr13,2575761,2565279,5141040,2.2476589028704823,TNTM,114364328
13,chr14,2177862,2166532,4344394,2.029261539663635,TNTM,107043718
14,chr15,1966494,1965361,3931855,1.9275464079549067,TNTM,101991189
15,chr16,1706752,1698354,3405106,1.8846404591538621,TNTM,90338345
16,chr17,1644804,1641592,3286396,1.973635005188305,TNTM,83257441
17,chr18,1965854,1965289,3931143,2.445553270592337,TNTM,80373285
18,chr19,921287,923188,1844475,1.5733111698026068,TNTM,58617616
19,chr20,1391298,1374415,2765713,2.1458210484744105,TNTM,64444167
20,chr21,928633,925602,1854235,1.9848380163186956,TNTM,46709983
21,chr22,708170,709598,1417768,1.3949338260256094,TNTM,50818468
22,chrX,3502068,3498091,7000159,2.2430526946157285,TNTM,156040895
23,chrY,581187,578788,1159975,1.0134784176430125,TNTM,57227415
0,chr1,5835655,5819593,11655248,2.340820916843029,TYT,248956422
1,chr2,6432017,6401625,12833642,2.649460134832917,TYT,242193529
2,chr3,5237445,5237068,10474513,2.6411365571732244,TYT,198295559
3,chr4,5061938,5056407,10118345,2.659718915831651,TYT,190214555
4,chr5,4761437,4750632,9512069,2.619852435623501,TYT,181538259
5,chr6,4529595,4517551,9047146,2.6483692353649984,TYT,170805979
6,chr7,4005698,4004943,8010641,2.513600076984688,TYT,159345973
7,chr8,3811782,3820088,7631870,2.629165537975705,TYT,145138636
8,chr9,3079194,3083710,6162904,2.2265676514227057,TYT,138394717
9,chr10,3410855,3403877,6814732,2.546660428180746,TYT,133797422
10,chr11,3391689,3381193,6772882,2.5068662979817495,TYT,135086622
11,chr12,3360961,3351026,6711987,2.51809095411664,TYT,133275309
12,chr13,2657221,2640621,5297842,2.316212621823826,TYT,114364328
13,chr14,2307156,2286851,4594007,2.1458554905576057,TYT,107043718
14,chr15,2119723,2116136,4235859,2.0765808505281766,TYT,101991189
15,chr16,1884474,1871865,3756339,2.0790390835696626,TYT,90338345
16,chr17,1825783,1819886,3645669,2.1893952998147035,TYT,83257441
17,chr18,2066574,2061556,4128130,2.5680983426271555,TYT,80373285
18,chr19,1029052,1031806,2060858,1.7578828180252162,TYT,58617616
19,chr20,1542576,1515200,3057776,2.372422627481553,TYT,64444167
20,chr21,983127,978999,1962126,2.1003283173963045,TYT,46709983
21,chr22,801935,803595,1605530,1.5796717838877001,TYT,50818468
22,chrX,3632568,3629549,7262117,2.326991587686036,TYT,156040895
23,chrY,599695,596264,1195959,1.0449178946838678,TYT,57227415
0,chr1,2698081,2691121,5389202,1.0823585020835493,TTTH,248956422
1,chr2,3090837,3075906,6166743,1.2731023461820072,TTTH,242193529
2,chr3,2538597,2536610,5075207,1.2797076811992547,TTTH,198295559
3,chr4,2540058,2538329,5078387,1.3349102017981747,TTTH,190214555
4,chr5,2316575,2311603,4628178,1.2747114645403754,TTTH,181538259
5,chr6,2216660,2207956,4424616,1.295216954905308,TTTH,170805979
6,chr7,1927575,1925437,3853012,1.2090082753456217,TTTH,159345973
7,chr8,1832308,1836996,3669304,1.264068652264308,TTTH,145138636
8,chr9,1445692,1449644,2895336,1.0460428196836444,TTTH,138394717
9,chr10,1597797,1595301,3193098,1.1932584171913267,TTTH,133797422
10,chr11,1558178,1551661,3109839,1.1510536550392088,TTTH,135086622
11,chr12,1602113,1597280,3199393,1.200294722257969,TTTH,133275309
12,chr13,1332889,1324706,2657595,1.161898577325615,TTTH,114364328
13,chr14,1097847,1086377,2184224,1.0202485679729474,TTTH,107043718
14,chr15,977337,977001,1954338,0.9580915857349206,TTTH,101991189
15,chr16,822888,815697,1638585,0.9069155517515846,TTTH,90338345
16,chr17,786991,784392,1571383,0.9436892253270192,TTTH,83257441
17,chr18,1006610,1002200,2008810,1.2496751874705632,TTTH,80373285
18,chr19,407624,409926,817550,0.6973586233872083,TTTH,58617616
19,chr20,675775,660382,1336157,1.0366779975602758,TTTH,64444167
20,chr21,471617,468361,939978,1.0061853372971683,TTTH,46709983
21,chr22,321553,322338,643891,0.6335206720517431,TTTH,50818468
22,chrX,1753941,1749540,3503481,1.1226162859422204,TTTH,156040895
23,chrY,290854,287761,578615,0.5055400457979798,TTTH,57227415
